29 35
1 1
# # # # # # # # # # # # # # # # # # # # # # # # # # # # # # # # # # # 
# . # . . . . . . . . . . . . . . . . . . . # + . . . . . . . . . . # 
# + # . . . . . . * * * . * * * . . . . . . # + . . . . . . . . . . # 
# = # . . . . . . * . * . * . * . . . . . . # + . . . . . . . . . . # 
# + # . . . . . . . . . . * . * . . . . . . # + . . . . . . . . . . # 
# = # . . . . . . * . * . . . . . . . . . . # + . . . . . . . . . . # 
# + # . . . . . . * * * . * . * . . . . . . # S = = = = = = = = = # # 
# = # . . . . . . * * * . * . * . . . . . . . . . . . . . . . . . . # 
# + . . . . . . . . . . . . . . . . . . . . . . . . . . . . . . . . # 
# . . . . . . . . . . . . . . . . # S # . . . . . . . . . . + * . . # 
# . . . . . . . . . . . . . # # # # = # # # # . . . . . . . . . . . # 
# # # = # . . . . . . . . . . * * = + = * * . . . . . . . . # # # . # 
# * * . # # # . # # # # # . # # # # # # # # # . # . # . # # # # # . # 
# * * . # . # . # # # # # . . . . . . . . . . . # . # * . . . . = . # 
# * * . # . # . # # # # # . # # # . # # # # # # # . # # # # # # # . # 
# . . . # . . . . . . . . . . . # . . . # . . . . . # + . . . . # . # 
# # # - # # # # # # # # # . # - # # # # # . # # # . # # # # # . # . # 
# . = . . . . . . . # . . . . . . . . . . . # # # . . . . . . . # . # 
# . # . # . # . # . # # # . # # # # # # # # # # # # # # # . # # # . # 
# . # . . . . . . . . . # + . # # # . . + . . . # # # # # . # . . . # 
# . # # # # # # . # # . # * . # # # . . . . . . # # # # # . # . # . # 
# . . . . . # # . # # . # * . . = . . . . . . . # # # # # . # . # * # 
# # # # # . # # . = = . # . # # # # # # # # # = # # # # # . # . # . # 
# . . . # . # # . # # . . . . . . . . . # # # . . . . . # . # . # . # 
# . # . # . # # . # # # . . # # # # . . # # # . # # # . # . # . # . # 
# . # . # . . . . # # # . * # # # # . . # # # . . . # . . . # . # . # 
# . # # # . # # # # # # + * # # # # . . # # # # # # # # # # # . # . # 
# . . . . . . . . . . . . . . . . . . . . . . . . . . . . . . + . . # 
# # # # # # # # # # # # # # # # # # # # # # # # # # # # # # # # # # # 
